WWWWWWWWWW
WRRRRRRRRW
WRRRARRRRW
WRRRARRRRW
WRRRPRRRRW
WRRRARRRRW
WRRRRRRRRW
WRRRRRRRRW
WRRRRRRRRW
WWWWWWWWWW
