WWWWWWWWWW
WBBBBBBBBW
WBBBABBBBW
WBBBABBBBW
WBBBPBBBBW
WBBBABBBBW
WBBBBBBBBW
WBBBBBBBBW
WBBBBBBBBW
WWWWWWWWWW
