20
20
WWWWWWWWWWWWWWWWWWWW
WAAAAAGAAAAAAAAAAADW
W1AAAAAWAAAAAAAAAAAW
WRRRRRAWAAAAAADAAAAW
WRRRRRDWAAAAAAAAAAAW
WRRRRRDWAAAAAAAAA1AW
WWWWWWWWAAAAAAAAAAAW
WGGGGGGGAAAAAAAAAAAW
WGGGDGGGAAAAAAAAAAAW
WGGGDGGGAAAAAAAAAAAW
WAA1AAAAAAAAAAAAAAGW
WAAAAAAAAAAAAAAAAGAW
WAAAAAAAAAAAAAAAGAAW
W1AAAAAAAA1AAAAGAAAW
WAAAAAAAAAAAAAAAAAEW
WAAAAAAAAAAAAAAGAAAW
WRRRRRAAAAAAAAAAGAAW
WDDDDDAAAAAAAAAAAGAW
WRRRRRAAAAAAAAAAAAGW
WWWWWWWWWWWWWWWWWWWW
