20
20
WWWWWWWWWWWWWWWWWWWW
WDDDDDDAAWAAADDDDDDW
WGGGGGGAAWAAAGGGGGGW
W1A1A1AAAWAAA1A1A1AW
WAAAAAAAAWAAAAAAAAAW
WAAAAAAARARAAAAAAAAW
WWWWWWWWWAWWWWWWWWWW
WAAAAAAAAAAAAAAAAAAW
WAAAAAAAAAAAAAAAAAAW
WAAAAAAAWAWAAAAAAAAW
WAAAAAAWAAAWAAAAAAAW
WAAAAAWAAAAAWAAAAAAW
WAAAAWAAAAAAAWAAAAAW
WAAAWAAAAAAAAAAWAAAW
WAAWAAAAAAAAAAAAWAAW
WAWAAAAAAAAAAAAAAWAW
WWAAAAAAAAAAAAAAAAWW
WGGGGGGGGGGGGGGGGGGW
WRRRRRRRRERRRRRRRRRW
WWWWWWWWWWWWWWWWWWWW
