20
20
WWWWWWWWWWWWWWWWWWWW
WAAAAAAAAAAAAAAAAAAW
WAAARAAAAAAAAAAAAAAW
WAAAARRAARRRAAAAA1AW
WAAGGGAAAAGGGGGAAAAW
W1AAAAAAAAAAAAAAAAAW
WAAAAAAAAAAAAAAAAAAW
WAAAAAAAAAAAAAAGGGGW
WWWWWWWWWAAWWWWWWWWW
WAAAAAAARAAARGAAAAAW
WAAAAAAARAAARGAAAAAW
WRRRRAAAAAAAAAARRRRW
WGGGGAAAAAAAAAAAAAAW
WAA1AAAAAAAA2AAAAAAW
WAAAAA2AAAAAAAAAAAAW
WAAAWAAAWAAAWAAAWAAW
WGGAWAAAWAAAWAAAWAAW
WAAAWAAAWAAAWAAAWAAW
WDDDWDDDWDDDWDDDWDEW
WWWWWWWWWWWWWWWWWWWW