20
20
WWWWWWWWWWWWWWWWWWWW
WW1AAAADAAA1AAAAARAW
WWAAAAWWWWWWWWAAADAW
WAWDAWAAAAAAAAWAAAAW
WAWAW1AAWWWWAA1WAA1W
WAAAWAAWAAAAWAAAWAAW
WAWADWAWAWwAAWAAWAAW
W1DW1WAWDEWAAWAAWA1W
WAAWAWAWDDWGGWAAWDAW
WAAWAW1AWWAGGWAAWAAW
WAAWARAAGGAAWAAWAAAW
W1AWAAWAGGAWAAWAAAAW
WRAWAADWGGWGGWAAAAAW
WAAAWAAAWWAAWAAAAARW
WRAAAWAAAAAWAAAADAAW
WGGAAAWAAAWAAAAAAAAW
WGGDAAAWWWAAAAAAAAAW
WRRGAAAAAAAAAAGGGRAW
WRGGGGGAGDAAAAGGRGAW
WWWWWWWWWWWWWWWWWWWW
