20
20
WWWWWWWWWWWWWWWWWWWW
WWDADAAA1AAAAAAAAAAW
WEWAADADAAAAAGDAAAAW
WAAWAAAAAGAAAAAARGAW
WAAAWAARAARARAAAAAAW
WAGAAWARAAGADAAGAAAW
WGAAAAWAAAAAAAAAAAAW
WDAAAAAWAAAAARGADAAW
WAAAAAGAWAAAARARAAAW
WAGDAAAAAWAAAAAAAAAW
WAAARAAAAAWAAAADAAAW
WADA1GAAAAAWAAAAAGAW
WARAAAAAAAAAWAAAAAAW
WAAAAAADAA1AAWAAAAAW
WA1ARGAAAAAAAAWAAAAW
WAGAADAAADGAAAAWAAAW
WAAAAAAAARAAAAAAWAAW
WAADAAGAGAAAG1AAAWAW
WAAAAAAAAAAAAAAAAAAW
WWWWWWWWWWWWWWWWWWWW
